++++++++++++++++++++++++++++++
+                            +
+                            +
+                            +
+                            +
+         @                  +
+                            +
+                            +
+                            +
+                            +
++++++++++++++++++++++++++++++