+++++++++++++++++++++
+        @          +
+                  +
+                ++
++++   +++++      +
++++   ++++++++++++
++++++   +++   ++++
++             ++++
+++++++++++++++++++